15
0 0 0 0 0 0 0 0 0 0 0 0 0 0 0
B B 0 0 T T T 0 0 0 S 0 0 B B
0 S 0 0 0 0 0 0 W W 0 0 0 0 0
0 0 0 0 0 0 0 0 0 W 0 0 0 0 0
0 0 0 0 0 0 0 0 0 0 0 0 0 0 0
B B 0 0 0 0 0 S S T 0 0 0 B B
0 0 B T T 0 0 0 0 0 0 0 0 0 0
0 0 0 0 B B 0 0 0 0 0 S 0 0 0
0 0 0 0 0 0 B B 0 0 0 0 0 0 0
S 0 0 W 0 0 0 0 B B 0 0 0 0 0
0 0 0 W W 0 0 0 0 0 B B 0 0 0
0 0 0 0 W 0 0 S 0 0 0 0 B B T
0 0 0 0 P 0 0 0 0 0 0 0 0 0 T
B B 0 0 0 T 0 B B B 0 0 0 0 T
T 0 0 0 0 0 0 0 0 0 0 0 0 0 0