8
S 0 0 0 T 0 0 0
0 0 0 0 0 0 0 0
0 S 0 0 B 0 0 0
0 0 S P W 0 0 0
0 0 0 0 0 0 0 0
0 0 0 0 0 0 0 0
0 0 S T 0 0 0 0
0 0 0 0 0 0 0 0